"filename", "language", "JavaScript", "JavaScript JSX", "CSS", "comment", "blank", "total"
"c:\Users\gk725\Desktop\MERN\typing\src\App.css", "CSS", 0, 0, 69, 0, 3, 72
"c:\Users\gk725\Desktop\MERN\typing\src\App.jsx", "JavaScript JSX", 0, 29, 0, 1, 4, 34
"c:\Users\gk725\Desktop\MERN\typing\src\components\Keyboard\Key.jsx", "JavaScript JSX", 0, 28, 0, 0, 3, 31
"c:\Users\gk725\Desktop\MERN\typing\src\components\Keyboard\Keyboard.css", "CSS", 0, 0, 55, 2, 7, 64
"c:\Users\gk725\Desktop\MERN\typing\src\components\Keyboard\Keyboard.jsx", "JavaScript JSX", 0, 34, 0, 0, 8, 42
"c:\Users\gk725\Desktop\MERN\typing\src\components\Keyboard\Row.jsx", "JavaScript JSX", 0, 12, 0, 0, 2, 14
"c:\Users\gk725\Desktop\MERN\typing\src\components\Keyboard\config.js", "JavaScript", 6, 0, 0, 0, 1, 7
"c:\Users\gk725\Desktop\MERN\typing\src\components\LiveStats.jsx", "JavaScript JSX", 0, 75, 0, 0, 8, 83
"c:\Users\gk725\Desktop\MERN\typing\src\components\Navbar.js", "JavaScript", 0, 0, 0, 0, 1, 1
"c:\Users\gk725\Desktop\MERN\typing\src\components\Test.css", "CSS", 0, 0, 88, 0, 4, 92
"c:\Users\gk725\Desktop\MERN\typing\src\components\Test.jsx", "JavaScript JSX", 0, 116, 0, 1, 9, 126
"c:\Users\gk725\Desktop\MERN\typing\src\components\TestOptions.jsx", "JavaScript JSX", 0, 0, 0, 0, 1, 1
"c:\Users\gk725\Desktop\MERN\typing\src\components\TestProgress.jsx", "JavaScript JSX", 0, 14, 0, 0, 3, 17
"c:\Users\gk725\Desktop\MERN\typing\src\components\TestResult.jsx", "JavaScript JSX", 0, 92, 0, 0, 5, 97
"c:\Users\gk725\Desktop\MERN\typing\src\components\Text\Text.css", "CSS", 0, 0, 54, 1, 2, 57
"c:\Users\gk725\Desktop\MERN\typing\src\components\Text\Text.jsx", "JavaScript JSX", 0, 50, 0, 0, 9, 59
"c:\Users\gk725\Desktop\MERN\typing\src\components\Text\Word.jsx", "JavaScript JSX", 0, 42, 0, 0, 6, 48
"c:\Users\gk725\Desktop\MERN\typing\src\components\config.js", "JavaScript", 2, 0, 0, 0, 1, 3
"c:\Users\gk725\Desktop\MERN\typing\src\components\context\TestContextProvider.jsx", "JavaScript JSX", 0, 111, 0, 1, 9, 121
"c:\Users\gk725\Desktop\MERN\typing\src\hooks\useTestContext.js", "JavaScript", 9, 0, 0, 0, 2, 11
"c:\Users\gk725\Desktop\MERN\typing\src\hooks\useTestResult.js", "JavaScript", 0, 0, 0, 0, 1, 1
"c:\Users\gk725\Desktop\MERN\typing\src\index.css", "CSS", 0, 0, 50, 0, 6, 56
"c:\Users\gk725\Desktop\MERN\typing\src\main.jsx", "JavaScript JSX", 0, 5, 0, 0, 2, 7
"c:\Users\gk725\Desktop\MERN\typing\src\pages\About.jsx", "JavaScript JSX", 0, 5, 0, 0, 3, 8
"c:\Users\gk725\Desktop\MERN\typing\src\pages\Main.jsx", "JavaScript JSX", 0, 5, 0, 0, 3, 8
"c:\Users\gk725\Desktop\MERN\typing\src\pages\Setting.jsx", "JavaScript JSX", 0, 5, 0, 0, 3, 8
"c:\Users\gk725\Desktop\MERN\typing\src\pages\Stats.jsx", "JavaScript JSX", 0, 5, 0, 0, 3, 8
"c:\Users\gk725\Desktop\MERN\typing\src\utils\keys.js", "JavaScript", 5, 0, 0, 1, 1, 7
"Total", "-", 22, 628, 316, 7, 110, 1083